Abomination	Mark Tedin	U3
Alabaster Potion	Harold McNeill	C3
Ali Baba	Julie Baroh	U1
Amrou Kithkin	Quinton Hoover	C3
Amulet of Kroog	Margaret Organ-Kean	C3
Angry Mob	Drew Tucker	U3
Apprentice Wizard	Dan Frazier	U3
Ashes to Ashes	Drew Tucker	C2
Ashnod's Battle Gear	Mark Poole	U3
Backfire	Brian Snõddy	U1
Ball Lightning	Quinton Hoover	U1
Battering Ram	Jeff A. Menges	C3
Bird Maiden	Kaja Foglio	C3
Black Mana Battery	Anson Maddocks	U1
Blight	Pete Venters	C1
Blood Lust	Anson Maddocks	U3
Blue Mana Battery	Amy Weber	U1
Bog Imp	Ron Spencer	C3
Brainwash	Pete Venters	C1
Bronze Tablet	Tom Wänerstrand	U1
Brothers of Fire	Mark Tedin	C1
Circle of Protection: Artifact	Quinton Hoover	U1
Carnivorous Plant	Richard Thomas	C3
Carrion Ants	Drew Tucker	U1
Cave People	Pete Venters	U1
Clay Statue	Jesper Myrfors	C3
Clockworck Avian	Randy Asplund-Faith	U1
Colossus of Sardia	Jesper Myrfors	U1
Coral Helm	Amy Weber	U1
Cosmic Horror	Jesper Myrfors	U1
Crimson Manticore	Daniel Gelon	U1
Cursed Rack	Richard Thomas	C1
Cyclopean Mummy	Edward P. Beard, Jr.	U3
Detonate	Randy Asplund-Faith	U1
Diabolic Machine	Anson Maddocks	C1
Divine Transf.	NéNé Thomas	U1
Durkwood Boars	Mike Kimble	C3
Elder Land Wurm	Quinton Hoover	U1
Elven Riders	Melissa A. Benson	U1
Energy Tap	Daniel Gelon	C2
Erosion	Pete Venters	C3
Eternal Warrior	Anson Maddocks	U3
Fellwar Stone	Quinton Hoover	U3
Fissure	Douglas Shuler	C1
Flood	Dennis Detwiller	U6
Fortified Area	Randy Asplund-Faith	U3
Gaseous Form	Phil Foglio	C1
Ghost Ship	Tom Wänerstrand	C2
Giant Strength	Justin Hampton	C3
Giant Tortoise	Kaja Foglio	C3
Goblin Rock Sled	Dennis Detwiller	C3
Grapeshot Catapult	Dan Frazier	C3
Greed	Phil Foglio	U1
Green Mana Battery	Christopher Rush	U1
Hurr Jackal	Drew Tucker	U1
Immolation	Scott Kirschner	C3
Inferno	Randy Asplund-Faith	U1
Ironclaw Orcs	Anson Maddocks	C3
Junun Efreet	Christopher Rush	U1
Killer Bees	Phil Foglio	U3
Kismet	Kaja Foglio	U1
Land Leeches	Quinton Hoover	C3
Land Tax	Brian Snõddy	U1
Leviathan	Mark Tedin	U1
Lost Soul	Randy Asplund-Faith	C3
Mana Clash	Mark Tedin	U1
Marsh Gas	Douglas Shuler	C3
Marsh Viper	Ron Spencer	C3
Mind Bomb	Mark Tedin	U1
Mishra's Factory	Kaja Foglio & Phil Foglio	U3
Morale	Mark Poole	C2
Murk Dwellers	Drew Tucker	C3
Nafs Asp	Christopher Rush	C2
Oasis	Brian Snõddy	C1
Osai Vultures	Dan Frazier	C2
Piety	Mark Poole	C3
Pikemen	Dennis Detwiller	C3
Pit Scorpion	Scott Kirschner	U3
Pradesh Gypsies	Quinton Hoover	U6
Psionic Entity	Justin Hampton	U1
Pyrotechnics	Anson Maddocks	C1
Radjan Spirit	Christopher Rush	U1
Rag Man	Daniel Gelon	U1
Rebirth	Mark Tedin	U1
Red Mana Battery	Mark Tedin	U1
Relic Bind	Christopher Rush	U1
Sandstorm	Brian Snõddy	C3
Seeker	Mark Poole	U6
Segovian Leviathan	Melissa A. Benson	U3
Shapeshifter	Dan Frazier	U1
Sindbad	Julie Baroh	U1
Sisters of the Flame	Jesper Myrfors	C1
Spirit Link	Kaja Foglio	U1
Spirit Shackle	Edward P. Beard, Jr.	C2
Strip Mine	Daniel Gelon	U3
Sunken City	Jesper Myrfors	C3
Sylvan Library	Harold McNeill	U1
Tawnos's Wand	Douglas Shuler	C1
Tawnos's Weaponry	Dan Frazier	C1
Tempest Efreet	NéNé Thomas	U1
Tetravus	Mark Tedin	U1
The Brute	Mark Poole	U3
Time Elemental	Amy Weber	U1
Triskelion	Douglas Shuler	U1
Tundra Wolfes	Quinton Hoover	C3
Twiddle	Rob Alexander	C3
Uncle Istvan	Daniel Gelon	U1
Untamed Wilds	NéNé Thomas	U3
Urza's Avenger	Amy Weber	U1
Vampire Bats	Anson Maddocks	C3
Venom	Tom Wänerstrand	C3
Visions	NéNé Thomas	U1
Wall of Dust	Richard Thomas	C1
Wall of Spears	Sandra Everingham	C1
Whirling Dervish	Susan Van Camp	U3
White Mana Battery	Anthony S. Waters	U1
Winds of Change	Justin Hampton	U1
Winter Blast	Kaja Foglio	U1
Word of Binding	Ron Spencer	U3
Xenic Poltergeist	Dan Frazier	U1
Yotian Soldier	Christopher Rush	C3
Zephyr Falcon	Heather Hudson	C3
