Abu Ja'Far	Ken Meyer, Jr.	C6
Aladdin	Julie Baroh	U1
Ali Baba	Julie Baroh	U2
Amulet of Kroog	Margaret Organ-Kean	C3
Argothian Pixies	Amy Weber	U2
Ashnod's Battle Gear	Anson Maddocks	U3
Ashnods Altar	Mark Poole	U2
Ashnods Transmogrant	Mark Tedin	C4
Battering Ram	Jeff A. Menges	C4
Bird Maiden	Kaja Foglio	C3
Bronze Tablet	Tom Wänerstrand	U1
Circle of Protection: Artifacts	Pete Venters	U3
City of Brass	Mark Tedin	U3
Clay Statue	Jesper Myrfors	C6
Clockworck Avian	Randy Asplund-Faith	U2
Colossus of Sardia	Jesper Myrfors	U2
Coral Helm	Amy Weber	U3
Cuombajj Witches	Kaja Foglio	C6
Cursed Rack	Richard Thomas	U2
Cyclone	Mark Tedin	U1
Dandan	Drew Tucker	U3
Detonate	Randy Asplund-Faith	U1
Erhnam Djinn	Ken Meyer, Jr.	U2
Feldon's Cane	Mark Tedin	U3
Fishliver Oil	Anson Maddocks	U3
Ghazban Ogre	Jesper Myrfors	U3
Giant Tortoise	Kaja Foglio	C4
Goblin Artisans	Julie Baroh	U3
Grapeshot Catapult	Dan Frazier	C6
Hasran Ogress	Dan Frazier	C4
Hurr Jackal	Drew Tucker	U2
Ironclaw Orcs	Anson Maddocks	C6
Jalum Tome	Tom Wänerstrand	U2
Jeweled Bird	Amy Weber	U3
Junun Efreet	Christopher Rush	U3
Metamorphosis	Christopher Rush	U2
Mishra's Factory	Kaja Foglio & Phil Foglio	U6
Nafs Asp	Christopher Rush	C4
Oasis	Brian Snõddy	U2
Obelisk of Undoing	Tom Wänerstrand	U3
Rakalite	Christopher Rush	U2
Repentant Blacksmith	Drew Tucker	U3
Sandstorm	Brian Snõddy	C6
Shapeshifter	Dan Frazier	U2
Sindbad	Julie Baroh	U2
Strip Mine	Daniel Gelon	U9
Tawnos's Wand	Douglas Shuler	U3
Tawnos's Weaponry	Dan Frazier	U3
Tetravus	Mark Tedin	U2
Triskelion	Douglas Shuler	U3
Twiddle	Rob Alexander	C4
Urza's Avenger	Amy Weber	U3
Urza's Mine	Anson Maddocks	C3
Urza's Mine	Anson Maddocks	C3
Urza's Mine	Anson Maddocks	C3
Urza's Mine	Anson Maddocks	C3
Urza's Power Plant	Mark Tedin	C3
Urza's Power Plant	Mark Tedin	C3
Urza's Power Plant	Mark Tedin	C3
Urza's Power Plant	Mark Tedin	C3
Urza's Tower	Mark Poole	C3
Urza's Tower	Mark Poole	C3
Urza's Tower	Mark Poole	C3
Urza's Tower	Mark Poole	C3
Wall of Spears	Sandra Everingham	C4
War Elephant	Kristen Bishop	C4
Xenic Poltergeist	Dan Frazier	U6
Yawgmoth Demon	Sandra Everingham	U3
Yotian Soldier	Christopher Rush	C4
